11111111
00100100
11000011
00101110
01000000
00110110
01000101
00010000
01101110
00100100
00100000
01110111
00000000
00000010
01010101
00000000
00000000
11111111
